1111111111111111111111111111111111
1E0000000000000C00000C000000000001
1010010100100000101001000000010001
1010010010101010001001000000010111
110000000C00C000000000000000000011
110000000000000C00000C000000000001
1010010100100000101001000000010111
1010010011101010001001000000010101
1P0000000C10C000000000000000000011
1111111111111111111111111111111111