1111111111111111111
1001000000000000011
1001000000000000001
1010001010101000001
1100000C00001000001
1000000000001000001
10000000E0000100001
1000000C0C000010001
100000000P0C0001011
10000000000C0000111
10000000000C0000111
1111111111111111111